11 10 0 0 0 0 0 0 0 12 0 9 0 11
12 0 9 8 5 3 3 4 0 0 0 8 0 0
0 0 0 0 6 0 0 6 0 0 5 3 3 7
3 3 4 0 6 0 0 6 8 0 6 0 0 0
0 0 6 0 6 8 0 6 0 0 6 0 11 0
11 0 2 3 1 0 0 6 0 0 6 8 0 0
9 0 0 0 0 0 0 2 3 3 1 0 12 10


